11111111111111111
100000P0100000001
110011111000000C1
1101C000000111111
1E0C0111110C00001
11100000000000P01
11111111111111111