1111111111111111111111
1000000P00000000000P01
10000C0B000B000C000001
1110000000111100000001
1111111000000000000001
1C000000001111100000C1
1E00000000C0B000011111
1111111111111111111111