11111111111111111
100001P0000000CE1
11110000111111111
11110000000111111
10P00011110000001
11100000000000001
11111111111111111
