11111111111
1P001000001
100CEC10001
11111111111