11111111111111111111111111111
1E111111111111111111111C11111
11111111111111111111111111111
1C1111111111111111111C1111111
11111111111111111111111111111
11111111111111111C11111111C11
11111111111111111111111111111
1C111111111111111111111111111
11111111111111111111111111111
111111111111111111111111111P1
11111111111111111111111111111