11111111111111111111111111111
1P0000C00B001B0C0000000C00001
10000001111111111000000000001
1000000000000C0000000000C0001
1E111111111111111111111111101
10000B000000100000000C0000001
100000001000C0010000000000001
10000000111111111000000000001
1C00B0000000000000000000000P1
11111111111111111111111111111
