1111111111111
1P00B00B00CP1
10000000000E1
1111111111111
