1111111111111111111
1P0000C000B00000011
1011111111111111011
10B0000C00000B00011
1011111111111111011
100B00000C000000P11
1011111111111111011
10000C000B000C0E011
1111111111111111111
