1111111111111111111111111111
1P000000000000000000000000C1
10111111111B11111111111111C1
1000000000B0000000000000C0C1
111111111101111111111110C0C1
1C000000B1010000000000B0C0C1
10111111010101111111110C0C1
10B000C0010101C00000010C0C1
1011111111010101111101C0C01
10B00000B0010101000B01C0C01
101111110111010111110100001
10B000C001C001010000B0111C1
101111111111C1011111101C0C1
100000000000000B0000C01C0C1
111111111111111111111101C0E1
1P00000000000000000000001001
1111111111111111111111111111
