111111111111111111111
1P0B0C0B0C0B0C0B0C0E1
101010101010101010101
1C0C0B0C0B0C0B0C0B0P1
111111111111111111111
