11111111111111111111111
1P00001B0001B0001B00C11
10111101111011110111101
1000C0100C001B00C000011
10111101111011110111101
10B00010C0010B00100C001
10111101111011110111101
10C000100001000010000E1
1011110111101111011111P
10000C1B00C10B00C1000C1
11111111111111111111111
