11111111111111111
1E0000P0000000001
110C11111000000C1
1111C000000111111
1E0C0111110C00001
11100000000000001
11111111111111111