11111111111111111
100000P0000000001
110C11111000000C1
1111C000000111111
1E0C0111110C00001
1110000H00E00R0I1
11111111111111111