11111111111
1P00110C001
100CEC10001
11111111111