11111111111
1P00100 001
100CEC10001
11111111111
