11111111111111111
1C011111111111111
10111111111111111
10111111111111110
101C1111111111111
1P000000000E000C1
11111111111111111