11111111111
1P001100001
100C0C10E01
11111111111