11111111111111111
100E00P0100000001
110011111000000C1
11111111111111111
1000000000000P001
10000000000000001
11111111111111111